50 98 49 1 1 89 77 80 59 85 59 75 84 1 83 81 72 1 1 1
48 1 53 1 51 59 55 13 54 13 1 73 53 1 1 1 41 1 1 1
51 1 1 54 64 84 51 1 1 1 1 43 1 38 1 1 1 39 74 53
1 55 53 80 86 85 1 1 1 50 44 83 77 1 1 1 69 82 1 1
65 82 50 1 53 77 75 84 84 59 67 77 90 90 44 57 78 79 1 1
51 1 65 47 49 52 1 1 1 1 1 1 81 85 75 79 38 42 1 1
89 80 62 63 63 66 1 1 2 64 50 1 1 1 59 80 41 82 1 1
57 81 71 81 73 80 80 65 1 50 81 1 1 1 68 1 73 68 1 1
1 1 1 1 1 1 1 1 1 1 1 1 1 1 77 53 1 1 1 1
1 1 1 1 1 1 1 1 1 1 1 1 1 1 68 50 1 1 37 48
1 1 1 1 1 50 1 51 1 1 90 64 82 66 85 82 82 54 51 45
67 84 80 66 1 51 80 39 1 1 1 86 71 77 67 73 47 65 53 1
1 1 1 1 1 1 1 1 1 51 1 50 1 1 51 74 45 1 1 1
1 1 1 1 1 1 1 1 1 52 54 98 41 65 55 1 43 1 1 1
1 1 1 1 1 1 1 1 1 1 1 1 1 1 1 1 1 1 1 1
1 1 1 1 1 1 1 1 1 1 1 1 1 1 1 1 1 1 1 1
1 1 1 1 1 1 1 1 1 1 1 1 1 1 1 1 1 1 1 1
1 1 1 1 1 1 1 1 1 1 1 1 1 1 1 1 1 1 1 1
1 1 1 1 1 1 1 1 1 1 1 1 1 1 1 1 1 1 1 1
1 1 1 1 1 1 1 1 1 1 1 1 1 1 1 1 1 1 1 1