0 0 0 0 0 0 0 0 0 0 0 0 0 0 130 0 0 95 159 158
0 0 0 0 0 0 0 0 0 0 0 0 0 0 153 142 17 95 168 167
0 0 0 0 0 0 0 203 204 204 205 0 0 0 133 134 105 95 0 0
0 0 0 0 0 0 0 0 0 0 0 0 0 0 139 143 105 181 118 120
111 112 0 0 0 0 0 0 0 0 0 0 0 0 0 0 177 104 128 125
0 104 0 0 0 0 0 0 0 0 0 0 0 0 0 0 105 104 0 0
0 110 111 113 114 114 114 114 114 114 114 114 112 0 0 0 182 104 0 0
0 0 0 0 0 0 0 0 0 0 0 0 95 0 0 0 105 104 113 112
131 142 126 101 118 123 101 101 121 101 101 101 102 0 0 0 100 102 0 104
176 134 96 129 127 3 107 125 107 107 107 125 109 0 0 0 6 109 0 104
139 143 0 0 0 0 0 0 0 0 0 0 0 0 0 0 0 0 0 183
0 0 0 0 0 0 0 0 0 0 0 0 0 0 0 0 0 0 0 94
11 123 101 120 101 118 101 121 122 17 0 0 0 0 0 0 116 126 11 102
12 3 15 15 15 12 14 127 129 18 0 0 0 0 0 0 104 96 12 109
0 0 0 0 0 0 0 0 0 100 101 123 120 11 11 11 102 0 0 0
0 0 0 0 0 0 0 0 0 106 97 3 125 12 14 15 109 0 0 0
0 0 0 0 0 0 0 0 0 0 0 0 0 0 0 0 0 0 0 0
0 0 0 0 0 0 0 0 0 0 0 0 0 0 0 0 0 0 0 0
0 0 0 0 0 0 0 0 0 0 0 0 0 0 0 0 0 0 0 0
0 0 0 0 0 0 0 0 0 0 0 0 0 0 0 0 0 0 0 0